10 10
0 4
1 1 1 1 0 1 1 1 1 1
1 0 0 1 0 1 0 0 0 1
1 0 0 0 0 0 0 1 0 1
1 0 1 1 1 1 0 1 0 1
1 0 1 0 0 1 0 1 0 1
0 0 1 1 1 1 0 0 0 1
1 1 1 0 1 0 0 1 0 1
0 0 1 0 1 0 1 1 0 1
1 0 1 0 0 0 0 0 0 1
1 0 1 1 1 1 1 1 1 1

10 10
0 4
1 1 1 1 0 1 1 1 1 1
1 0 0 1 0 1 0 0 0 1
1 0 0 0 0 0 0 1 0 1
1 0 1 1 1 1 0 1 0 1
1 0 1 0 0 1 0 1 0 1
1 0 1 1 1 1 0 0 0 1
1 1 1 0 1 0 0 1 0 1
0 0 1 0 1 0 1 1 0 0
1 0 1 0 0 0 0 0 0 1
1 0 1 1 1 1 1 1 1 1

10 10
5 0
1 1 1 1 0 1 1 1 1 1
1 0 0 1 0 1 0 0 0 1
1 0 0 0 0 0 0 1 0 1
1 0 1 1 1 1 0 1 0 1
1 0 1 0 0 1 0 1 0 1
0 0 1 1 1 1 0 0 0 1
1 1 1 0 1 0 0 1 0 1
0 0 1 0 1 0 1 1 0 1
1 0 1 0 0 0 0 0 0 1
1 0 1 1 1 1 1 1 1 1

10 10
7 9
1 1 1 1 0 1 1 1 1 1
1 0 0 1 0 1 0 0 0 1
1 0 0 0 0 0 0 1 0 1
1 0 1 1 1 1 0 1 0 1
1 0 1 0 0 1 0 1 0 1
1 0 1 1 1 1 0 0 0 1
1 1 1 0 1 0 0 1 0 1
0 0 1 0 1 0 1 1 0 0
1 0 1 0 0 0 0 0 0 1
1 0 1 1 1 1 1 1 1 1

10 10
9 1
1 1 1 1 0 1 1 1 1 1
1 0 0 1 0 1 0 0 0 1
1 0 0 0 0 0 0 1 0 1
1 0 1 1 1 1 0 1 0 1
1 0 1 0 0 1 0 1 0 1
1 0 1 1 1 1 0 0 0 1
1 0 0 0 1 0 0 1 0 1
1 0 1 0 1 0 1 1 0 1
1 0 1 0 0 0 0 0 0 1
1 0 1 1 1 1 1 1 1 1

10 10
0 4
1 1 1 1 0 1 1 1 1 1
1 0 0 1 0 1 0 0 0 1
1 0 0 0 0 0 0 1 0 1
1 0 1 1 1 1 0 1 0 1
1 0 1 0 0 1 0 1 0 1
1 0 1 1 1 1 0 0 0 1
1 0 0 0 1 0 0 1 0 1
1 0 1 0 1 0 1 1 0 1
1 0 1 0 0 0 0 0 0 1
1 0 1 1 1 1 1 1 1 1

10 10
4 0
1 1 1 1 1 1 1 1 1 1
1 0 0 1 1 1 0 0 0 1
1 0 0 0 0 0 0 1 0 1
1 0 1 1 0 1 0 1 0 1
0 0 1 0 0 1 0 0 0 1
1 0 1 0 1 1 0 1 0 1
1 0 1 0 1 0 0 1 0 1
1 0 1 0 1 0 1 1 0 1
1 0 1 0 0 0 0 0 0 0
1 1 1 1 1 1 1 1 1 1

10 10
8 9
1 1 1 1 1 1 1 1 1 1
1 0 0 1 1 1 0 0 0 1
1 0 0 0 0 0 0 1 0 1
1 0 1 1 0 1 0 1 0 1
0 0 1 0 0 1 0 0 0 1
1 0 1 0 1 1 0 1 0 1
1 0 1 0 1 0 0 1 0 1
1 0 1 0 1 0 1 1 0 1
1 0 1 0 0 0 0 0 0 0
1 1 1 1 1 1 1 1 1 1

10 10
9 3
1 1 1 1 1 1 1 1 1 1
1 0 0 0 0 0 0 0 0 1
1 0 1 1 0 1 0 1 0 1
1 0 0 0 1 1 0 1 0 1
1 0 1 0 1 1 0 0 0 1
1 0 1 0 1 1 0 1 0 1
1 0 1 0 1 0 0 1 0 1
1 0 1 0 1 0 1 1 0 1
1 0 1 0 1 0 0 0 0 0
1 1 1 0 1 1 1 1 1 1

15 15
14 2
0 1 1 1 0 1 1 0 0 1 1 0 0 1 0 
1 0 0 1 1 0 0 0 1 1 1 1 0 1 0 
1 1 0 0 0 0 0 0 0 0 0 0 0 0 0 
1 1 0 0 1 1 0 1 1 1 0 1 0 0 1 
1 0 0 1 1 1 1 1 0 1 1 1 1 1 0 
1 1 0 0 0 0 0 0 0 1 1 0 0 0 1 
1 1 0 0 0 1 1 1 0 0 0 1 1 1 0 
1 1 1 0 0 1 0 0 0 1 0 1 1 0 0 
0 1 1 1 1 0 1 1 1 1 0 1 1 1 1 
1 1 0 0 1 1 0 1 1 1 0 0 1 1 1 
0 1 1 1 1 1 1 1 0 0 0 1 1 1 1 
1 1 1 0 0 0 1 1 1 0 1 0 1 1 1 
1 1 0 0 1 0 1 0 1 0 1 1 1 0 1 
1 1 0 1 1 0 0 0 0 0 0 1 0 0 1 
1 1 0 1 1 1 1 1 1 1 0 1 1 0 1

15 15
0 12
1 1 1 1 0 1 1 1 1 1 1 1 0 1 1 
1 1 0 1 1 0 0 0 1 1 1 1 0 1 1 
1 1 0 0 0 0 0 0 0 0 0 0 0 0 1 
1 1 0 0 1 1 0 1 1 1 0 1 0 0 1 
1 0 0 1 1 1 1 1 0 1 1 1 1 1 0 
1 1 0 0 0 0 0 0 0 1 1 0 0 0 1 
1 1 0 0 0 1 1 1 0 0 0 1 1 1 0 
1 1 1 0 0 1 0 0 0 1 0 1 1 0 0 
0 1 1 1 1 0 1 1 1 1 0 1 1 1 1 
1 1 0 0 1 1 0 1 1 1 0 0 1 1 1 
0 1 1 1 1 1 1 1 0 0 0 1 1 1 1 
1 1 1 0 0 0 1 1 1 0 1 0 1 1 1 
1 1 0 0 1 0 1 0 1 0 1 1 1 0 1 
1 1 0 1 1 0 0 0 0 0 0 1 0 0 1 
1 1 0 1 1 1 1 1 1 1 1 1 1 0 1

